011111111A111111112
7                 3
7                 3
7                 3
7                 3
7                 3
7                 3
D                 B
7                 3
7                 3
7                 3
7                 3
7                 3
7                 3
655555555C555555554